One Direction - Story of My Life
Mark Ambor - Belong Together
DJ Snake & Bipolar Sunshine - Paradise
David Guetta, Alphaville & Ava Max - Forever Young
Imagine Dragons - On Top of the World
Taylor Swift - The Fate of Ophelia
Kevin Lyttle - Turn Me On
Ida-Lova - Svagare än jag
The Script & will.i.am - Hall of Fame
Alex Warren - Eternity
Justin Bieber - DAISIES
ROSÉ & Bruno Mars - APT.
Darin - Allt jag har
Westlife - Chariot
Jonas Blue - Fast Car
Shaboozey & Myles Smith - Blink Twice
Lewis Capaldi - Someone You Loved
Ed Sheeran - Sapphire
Greczula - Believe me
Ava Max - Sweet but Psycho
LIAMOO - Break Through The Ceiling
Toploader - Dancing In the Moonlight
Ella Tiritiello - Jag lovar
Miriam Bryant & Victor Leksell - tystnar i luren
Huntr X & Ejae & Audrey Nuna & Rei Ami & Kpop Demon Hunters Cast - Golden
Onerepublic & Timbaland - Apologize
Taylor Swift - Cruel Summer
Peg Parnevik - Jag Har Hört
Shaggy - Angel
Molly Sandén - Blåögd
Benson Boone - Mystical Magical
Swedish House Mafia - Don't You Worry Child
Marcus & Martinus - Wonder
Maroon 5 - Moves Like Jagger
Myra Granberg - Lose my mind
Jubel & Alida - Waiting For A Star To Fall
Billie Eilish - BIRDS OF A FEATHER
Tjuvjakt & Fanny Avonne - Tusen spänn
Christopher - Orbit
RAYE - WHERE IS MY HUSBAND!
Nico Santos - All Time High
Katy Perry - Hot 'n' Cold
Purple Disco Machine & Benjamin Ingrosso - Honey Boy
Agnes - Ego
Axwell Λ Ingrosso - Sun Is Shining
Pink - Trustfall
David Guetta & Bebe Rexha - I'm Good
FELICIA - Black Widow
Spice Girls - Wannabe
Myles Smith - Stay
Norlie & KKV - Tröjan du hatar
Luis Fonsi & Demi Lovato - Échame La Culpa
Ed Sheeran - Azizam
September - Cry For You
Robyn - Hang with Me