Behöver inte dig idag - Clara Klingenström
Celebration - Kool and The Gang
Grace Kelly - Mika
Sorry I'm Here For Someone Else - Benson Boone
Smooth Criminal - Michael Jackson
Six Feet Under - Smash Into Pieces
Cherish - Madonna
Joyride - Roxette
Genom Eld Och Vatten - Medina
Despacito - Luis Fonsi and Justin Bieber
Funky Town - Lipps Inc
Allt Jag Har - Darin
Alive. - Da Buzz
Poison - Alice Cooper
Murder On The Dancefloor - Sophie Ellis-Bextor
West End Girls - Pet Shop Boys
If Only You - Danny and Therese
Hälsa Gud - Miss Li
Gimme Gimme Gimme - Abba
I've Been Thinking About You - Londonbeat
För Evigt - Hanna Ferm
Forgive Me Friend - Smith and Thell ft. Swedish Jam Factory
I Want It All - Queen
The Fate Of Ophelia - Taylor Swift
I'm Alive. - Celine Dion
Oh Mama - Lili and Susie
Cheri Cheri Lady - Modern Talking
What About Us - Pink
Die With A Smile - Lady GaGa and Bruno Mars
Mimosa - Darin
Hot N Cold - Katy Perry
Sleeping in My Car - Roxette
Eternity - Alex Warren
Vart Jag än Går - Stiftelsen
You Give Love A Bad Name - Bon Jovi
Blåögd - Molly Sandén
Message in a Bottle - Taylor Swift
Straight Up - Paula Abdul
Bara Du är Där - Ella Tiritiello
Più bella cosa - Eros Ramazzotti
Baby Baby - Corona
Misstag - Miss Li
Summer Of 69 - Bryan Adams
Blink Twice - Shaboozey and Myles Smith
Cry For You - September
Thorn In My Side - Eurythmics
Heaven Is A Place On Earth - Belinda Carlisle
Just The Way You Are - Bruno Mars