Samantha Fox - Nothing's Gonna Stop Me Now
Orup - Då Står Pojkarna På Rad
Fine Young Cannibals - Suspicious Minds
Jaki Graham - Set Me Free
Cliff Richard - We Don't Talk Anymore
Donna Summer - This Time I Know It's For Real
Carola - Säg Mig Var Du Står
Sheryl Lee Ralph - In the Evening
Baltimora - Tarzan Boy
Belinda Carlisle - Heaven Is A Place On Earth
Whitney Houston - So Emotional
Alice Cooper - He's Back
Laura Branigan - Self Control
Howard Jones - Like to Get to Know You Well
Rick Astley - Never Gonna Give You Up
Trance Dance - You're Gonna Get It
Wax - Bridge to Your Heart
Fiction Factory -  Heaven
Michael Jackson - Billie Jean
Eriksson Glenmark - Upp Över Mina Öron
Kenny Loggins - Danger Zone
Freda - I En Annan Del Av Världen
Steve Miller Band - Abracadabra
Modern Talking - Cheri Cheri Lady
The Whispers - And the Beat Goes On
Blondie - The Tide Is High
ABBA - The Winner Takes It All
Iggy Pop - Real Wild Child
Electric Light Orchestra - Last Train to London
Bronski Beat - Smalltown Boy
Madonna - Open Your Heart
Britney Spears - Born to Make You Happy
Kim Wilde - You Keep Me Hangin On
Backstreet Boys - Everybody
Diana Ross - Upside Down
Bob Marley & The Wailers - Buffalo Soldier
F.R. David - Words
Phil Collins - Don't Lose My Number
Dead or Alive - You Spin Me Round
Twisted Sister - We're Not Gonna Take It
Lena Philipsson - Kärleken Är Evig
Madonna - Like a Prayer
Mr. Big - Wild World
Dionne Warwick - Heartbreaker
Kylie Minogue - I Should Be So Lucky
Eagles - Hotel California
Secret Service - Flash in the Night
Pet Shop Boys - Suburbia
Bryan Adams - Summer of '69
Lionel Richie - All Night Long
Boney M. - Ma Baker
Climie Fisher - Love Changes
Corona - The Rhythm Of The Night
Chicago - You're the Inspiration
Prince & The Revolution - Kiss
Steve Winwood - Valerie
Abba - Knowing Me Knowing You
Opus - Live Is Life
Natalie Imbruglia - Torn
Harold Faltermayer - Axel F Theme
Nordman & Jox - Vandraren
Fleetwood Mac - Everywhere
Rainbow - Since You Been Gone
Cher - If I Could Turn Back Time
Michael Jackson - They Don't Care About Us
Abba - When I Kissed The Teacher
Bruce Springsteen - Cover Me
Sandra - Maria Magdalena
Savage Garden - Truly Madly Deeply
Gyllene Tider -  Leva Livet
Paula Abdul - Straight Up
*NSYNC - Bye Bye Bye
Aneka - Japanese Boy
Toto - Africa
Philip Bailey & Phil Collins - Easy Lover
Bonnie Tyler - It's a Heartache
Donna Summer - Hot Stuff
Kaoma - Lambada
Alphaville - Sounds Like a Melody
Michael Jackson - Black or White
Michael Sembello - Maniac
Bill Lovelady - One More Reggae for the Road
Toto - Hold the Line
Chris Rea - The Road to Hell
Desireless - Voyage voyage
Elton John - I'm Still Standing
Jon Bon Jovi - Blaze of Glory
U.S.A. for Africa - We Are the World
Fleetwood Mac - Go Your Own Way
Falco - Rock Me Amadeus
Anastacia - I'm Outta Love
ABBA - Gimme! Gimme! Gimme!
Def Leppard - Pour Some Sugar On Me
Modern Talking - You're My Heart, You're My Soul
Roxette - Neverending Love
Queen - We Will Rock You
Tomas Ledin - Hon Gör Allt För Att Göra Mig Lycklig
Berlin - Take My Breath Away
Tina Turner - The Best
Supertramp - Give a Little Bit