Céline Dion - It's All Coming Back to Me Now
Dean Lewis - How Do I Say Goodbye
Westlife - If I Let You Go
Coldplay - We Pray
Michael Jackson & Siedah Garrett - I Just Can't Stop Loving You
Bonnie Tyler - Total Eclipse of the Heart
Christopher - A Beautiful Life
Robbie Williams - Angels
Alessia Cara - Scars to Your Beautiful
Joe Cocker & Jennifer Warnes - Up Where We Belong
Lewis Capaldi - Forget Me
Celine Dion - My Heart Will Go On
Miley Cyrus - Flowers
Johnny Logan - Hold Me Now
Beyoncé - Halo
No Doubt - Don't Speak
Rod Stewart - What A Wonderful World
Taylor Swift - Anti-Hero
Europe - Carrie
Randy Crawford - Knockin' On Heaven' S Door
Britney Spears - Born to Make You Happy
Thomas Stenström - Ser du månen där du är ikväll?
U.S.A. for Africa - We Are the World
Sabrina Carpenter - Espresso
The Fray - How To Save a Life
Roxette - Wish I Could Fly
Benson Boone - In The Stars
Madonna - La Isla Bonita
Rag'n'Bone Man - Human
Michael Learns to Rock - The Actor
Alex Warren - Ordinary