Real Slim Shady - eminem
Paradise - Dj Snake With Bipolar Sunshine
Can't Get Enough - Tribbs ft. Klara Hammarström
Sapphire - Ed Sheeran
Mimosa - Darin
Tusen Spänn - Tjuvjakt ft. Fanny Avonne
Crush - Zara Larsson
Azizam - Ed Sheeran
Heaven - Zedd
Blåögd - Molly Sandén
Ingen Annan Rör Mig Som Du - Norlie and Kkv
Break Through The Ceiling - Liamoo
Fade Into Darkness - Avicii
A Bar Song - Shaboozey
I Had Some Help - Post Malone ft. Morgan Wallen
Blink Twice - Shaboozey and Myles Smith
Freestyler - Bomfunk MC’s
The Fate Of Ophelia - Taylor Swift
Blue Moon - Zara Larsson
Bad Habits - Ed Sheeran
Abracadabra - Lady GaGa
I'm Good - David Guetta and Bebe Rexha
Life - E-Type
Eternity - Alex Warren
WHAT’S LOVE GOT TO DO WITH IT - Kygo ft. Tina Turner
Camera - Ed Sheeran
Lose Yourself - eminem
Love Yourself - Justin Bieber
Forever Young - David Guetta ft. Alphaville and Ava Max
Ella Elle La - Kate Ryan
S& - Rihanna
Ordinary - Alex Warren
A Sky Full Of Stars - Coldplay
Golden - Huntr/x,ejae, Audrey Nuna, Rei Ami, Kpop Demon Hunters Cast
Children - Robert Miles
Blood Running - Ray Dalton