Vill Ha Dig - Freestyle
Forever Young - David Guetta, Alphaville and Ava Max
Oslagbara! - Niklas Strömstedt
Umbrella - Rihanna
Back To You - Benjamin Ingrosso
When All Is Said And Done - Abba
Children - Robert Miles
Never Ending Story - Limahl
Give My Heart A Break - Cazzi Opeia
Marry You - Bruno Mars
I Drove All Night - Celine Dion
Fairytale Gone Bad - Sunrise Avenue
Bad Boys - Inner Circle
Joe Le Taxi - Vanessa Paradis
Vart Jag än Går - Stiftelsen
Blood Running - Ray Dalton
Brother Louie - Modern Talking
Without You - Avicii
Behöver inte dig idag - Clara Klingenström
Pour Some Sugar On Me - Def Leppard
Daisies - Justin Bieber
Sleeping in My Car - Roxette
Hälsa Gud - Miss Li
Don't You Want Me - The Human League
Cry For You - September
Kärleken är Evig - Lena Philipsson
Sapphire - Ed Sheeran
La Isla Bonita - Madonna
Kung För En Dag - Magnus Uggla
On And On And On. - Klara Hammarström
Break My Stride - Matthew Wilder
Down Under - Men At Work
You're The Voice - John Farnham
Under Någon Ny - Miriam Bryant and Veronica Maggio
Get Lucky - Daft Punk and Pharrell Williams
I Want To Break Free - Queen
Where Is My Husband! - Raye
Black Or White - Michael Jackson
Nice To Meet You - Myles Smith
Tell It To My Heart - Taylor Dayne
Stumblin' In - CYRIL
I Won't Let The Sun Go Down On Me - Nik Kershaw
Eye Of The Tiger - Survivor
Vi är På Gång - Tomas Ledin
Crying At The Discotheque - Alcazar
Shut Up And Dance - Walk The Moon
Self Control - Laura Branigan
Ego - Agnes
Om - Niklas Strömstedt
Cold Heart - Elton John and Dua Lipa
Dangerzone - Kenny Loggins
I've Been Thinking About You - Londonbeat
Golden - Huntrix, Ejae, Audrey Nuna, Rei Ami, Kpop Demon Hunters Cast
Fula Gubbar - Magnus Uggla
What's The Point - Darin
Dansar I Månens Sken - Suzzies Orkester
Bara Få Va Mig Själv - Laleh
Two Hearts - Phil Collins
Mr Vain - Culture Beat
The Animal Song - Savage Garden
Don't Stop Believin' - Journey
Flowers - Miley Cyrus
Händerna Mot Himlen - Petra Marklund
Bad - Michael Jackson
Från Och Med Du - Oskar Linnros
Angel - Shaggy
The Look - Roxette
Blink Twice - Shaboozey and Myles Smith
Heroes - Måns Zelmerlöw
Run To You - Bryan Adams
Välkommen åter - Hanna Ferm and Junie
Oops I Did It Again - Britney Spears
Boys, Boys, Boys - Sabrina
ännu Doftar Kärlek - Marie Fredriksson
Mimosa - Darin
Blåögd - Molly Sandén
Beds Are Burning - Midnight Oil
My Number One - Helena Paparizou
Andas In Andas Ut - Thomas Stenström
Right Here Waiting - Richard Marx
Hello - Adele
Where Do You Go - No Mercy
Genom Eld Och Vatten - Sarek
Eternity - Alex Warren
The Actor - Michael Learns to Rock
Om Du Lämnade Mig Nu - Lars Winnerbäck and Miss Li
The Rhythm Of The Night - Corona
Still Loving You - Scorpions
Whenever Wherever - Shakira
Bed Of Roses - Bon Jovi
Take On Me. - A-Ha
The Winner Takes It All - Abba
Azizam - Ed Sheeran
I Wish It Would Rain Down - Phil Collins
Chariot - Westlife
You're My Heart, You're My Soul - Modern Talking
Unstoppable - Sia
Bara Du är Där - Ella Tiritiello
Più bella cosa - Eros Ramazzotti
The Fate Of Ophelia - Taylor Swift